LX,7,LY,7,PX,64,PY,64
1,1,1,1,1,1,1
1,0,0,0,0,0,1
1,0,1,0,1,0,1
1,0,0,0,0,0,1
1,0,1,1,1,0,1
1,0,0,0,0,0,1
1,1,1,1,1,1,1
1,1,1,1,1,1,1
1,1,1,1,1,1,1
1,1,1,1,1,1,1
1,1,1,1,1,1,1
1,1,1,1,1,1,1
1,1,1,1,1,1,1
1,1,1,1,1,1,1
1,1,1,1,1,1,1
1,1,1,1,1,1,1
1,1,1,1,1,1,1
1,0,1,0,1,0,1
1,0,0,0,0,0,1
1,0,1,1,1,0,1
1,0,0,0,0,0,1